Web
1. Lista de TODAS las etiquetas de la rúbrica con su propósito


#TAGS INICIALES O DE RAÍZ
Etiqueta	Descripción
<!DOCTYPE html>	Indica al navegador que el documento es HTML5.
<html></html>	Contenedor raíz de toda la página web.
#TAGS DE METADATOS DEL DOCUMENTO
Etiqueta	Descripción
<head></head>	Contiene información no visible directamente (título, estilos, metadatos).
<title></title>	Título de la página que aparece en la pestaña del navegador.
<!-- comentario -->	Añade comentarios en el código sin mostrarlos en la página.
<link>	Vincula archivos externos (como hojas de estilo CSS).
<meta>	Define metadatos como el conjunto de caracteres, descripción o viewport.
<style></style>	Permite escribir código CSS directamente dentro del HTML.
#TAGS DE SECCIONES
Etiqueta	Descripción
<body></body>	Contiene todo el contenido visible de la página.
<nav></nav>	Zona de navegación con menús o enlaces.
<main></main>	Contenido principal del sitio.
<section></section>	Sección temática de la página.
<article></article>	Contenido independiente (como una noticia o ficha).
<h1> a <h6>	Encabezados jerárquicos de diferentes niveles.
<header></header>	Encabezado del sitio o de una sección.
<aside></aside>	Información adicional o complementaria (como datos curiosos o anuncios).
<footer></footer>	Pie de página o créditos.
#TAGS DE AGRUPACIÓN DE CONTENIDO
Etiqueta	Descripción
<p></p>	Párrafo de texto.
<hr>	Línea horizontal de separación.
<pre></pre>	Texto preformateado (mantiene espacios y saltos).
<blockquote></blockquote>	Cita de un texto externo.
<ol></ol>	Lista ordenada (numerada).
<ul></ul>	Lista sin orden (con viñetas).
<li></li>	Elemento de lista.
<dl></dl>	Lista de definiciones.
<dt></dt>	Término dentro de una lista de definiciones.
<dd></dd>	Descripción del término definido.
<figure></figure>	Contenedor para imágenes, gráficos, etc.
<figcaption></figcaption>	Pie o descripción de una figura.
<map></map> y <area>	Mapa de imagen interactivo con áreas clicables.
<div></div>	Contenedor genérico (para agrupar bloques de contenido).
#TAGS SEMÁNTICAS PARA TEXTO
Etiqueta	Descripción
<a></a>	Enlace o hipervínculo.
<center></center>	Centra contenido (obsoleto pero lo pide la rúbrica).
<strong></strong>	Texto importante (en negrita semántica).
<small></small>	Texto pequeño (notas, comentarios).
<cite></cite>	Cita de un título de obra.
<samp></samp>	Muestra texto de salida de un programa.
<sub></sub> / <sup></sup>	Subíndice / superíndice.
<em></em>	Texto enfatizado (por defecto cursiva).
<s></s>	Texto tachado.
<font></font>	Define color o tamaño de fuente (obsoleta, pero pedida).
<q></q>	Cita corta dentro del texto.
<dfn></dfn>	Marca la primera aparición de una definición.
<abbr></abbr>	Abreviatura con significado completo (por ejemplo FIFA).
<time></time>	Marca una fecha u hora.
<code></code>	Fragmento de código o comando.
<i></i>	Texto en cursiva.
<ins></ins>	Texto insertado.
<mark></mark>	Texto resaltado.
<span></span>	Contenedor en línea para aplicar estilos.
<br>	Salto de línea.
<b></b>	Texto en negrita.
<big></big>	Texto más grande (obsoleto).
<u></u>	Texto subrayado.
<del></del>	Texto eliminado.
<kbd></kbd>	Representa texto que el usuario debe escribir.
<bdo></bdo>	Cambia la dirección del texto (ejemplo: derecha a izquierda).
<wbr>	Indica punto de quiebre de palabra.
#TAGS PARA INCRUSTAR CONTENIDO
Etiqueta	Descripción
<img>	Inserta una imagen.
<iframe></iframe>	Inserta contenido de otro sitio (como YouTube o mapas).
<embed>	Incrusta contenido externo.
<object></object> / <param>	Inserta archivos multimedia u objetos.
<video></video> / <source>	Inserta un video.
<audio></audio>	Inserta audio o música.
<address></address>	Dirección o información de contacto.
<svg></svg>	Gráficos vectoriales.
#TAGS PARA CREACIÓN DE TABLAS
Etiqueta	Descripción
<table></table>	Crea una tabla.
<caption></caption>	Título o descripción de la tabla.
<colgroup></colgroup>	Define grupo de columnas.
<thead></thead>	Encabezado de tabla.
<tbody></tbody>	Cuerpo principal de tabla.
<tfoot></tfoot>	Pie de tabla.
<tr></tr>	Fila de tabla.
<td></td>	Celda normal.
<th></th>	Celda de encabezado.
#TAGS PARA FORMULARIOS
Etiqueta	Descripción
<form></form>	Crea un formulario.
<fieldset></fieldset>	Agrupa campos relacionados.
<legend></legend>	Título del grupo de campos.
<label></label>	Etiqueta para un campo de entrada.
<input>	Campo de texto, correo, checkbox, etc.
<select></select>	Menú desplegable.
<datalist>	Lista de sugerencias para <input>.
<optgroup>	Grupo dentro de un <select>.
<option></option>	Elemento dentro de un <select>.
<textarea></textarea>	Campo de texto largo.
<button></button>	Botón de envío o acción.
#TAGS DE EXPRESIONES MATEMÁTICAS
Etiqueta	Descripción
<var></var>	Representa una variable matemática o de programación.